wwwwwwwwww
w    w  gw
w b      w
wwwwwww ww
w        w
w  b     w
w  wwwwwww
w   b w Bw
wg     gcw
wwwwwwwwww